11111111111111111111111111
1000000000001000000010E001
10001001C10000C00000100001
11100000000010000000010001
1111110000C000001000000001
10000000C0000000000C000001
1P0000010000100000C0000001
11111111111111111111111111
